>Rosalind_5923
CGGCGGCCCGAGGCCTCAGTGGCTATTCAACCCCTCGTTTGAGCCAATCGGTTAACGTAG
CAGCATTGCGTCTGAGCTGAGTCGACGATTCTAAGGGGCTGTACTGACATGTCAACAGGG
AGGCGGTGTAGCCCCGGCTTAATACCGTATAAGTTATATTCGTATTCGTCCTGTCCTACC
GACTGCCCGTCGCTGGGAACTAGTTTGGATACACGTACTAGTAATGCGGAATACATAGCC
TTAGGGCGCACCCCTCGATACCTCAAGCTGTTATCCGGGAACCCATCAGCTAACTTTGGT
TACGAAGCGGTTCGACTGGGGCCTTGTCCACTACGTCCTCGATGTTGACGTACTATCCAC
AGGGCTATGTGTAACTTTTACACGACGATTCATCTGGAGCCTTCGTGACCCACTTGAGTA
GTCACGTTATCGTCTCGAATTGCTGAGCCTGCAACCGGCATAATAATAAGCAAGATTATA
ATATCTTGTACCCTGCGGCCTTCCATTCACGGCAGGCAAACGTCCTTGGGGAAAAGGCCT
GGTCTCGTAGAATCCATTTCTTCTTCGACTTGACTCACGCCTTAGGCGGCTGGGGAGGTT
GTCCGCTACAAAACCCATTTAAATGGGGTGCGGGAGGAATGAGAACAACGCATATACCTA
AATCGGGTGAGTCAATTTCCACCCAAAACCCTTGTTTATTGGATTGGCGTACGATCCCTG
CTTGCCCAGGCTTTTGCACTGTGCAGCCTGGTGGTCAACTTATCTGTTGACCAACGCCAA
GGTCAAGTATTCGACCTTTCAGTCCAAGGGGTCAAACAGCTCAATTAAGTCCTCCTGGAG
GTCGTTTACTGCCTGCAGGGCGGCCGCACTTAATCCCAAGAGGTCATCGCGGCGGTCCGC
TCTGTTTTATGGCTACGACCTTGTGTACAGCAAACATTGGGCGGGAGTGACGCACCATAC
TTGCCTCGATCCTTAGGG
>Rosalind_5714
TCTTAAAGTTTAACTATCGGGTGGCCGGACACACTCCCCGAGCCTGTGAAGAACCGAAAG
CCGTTTGGGTAATACACCGGTCGTACTTCGAGCGAATTATTTCGTGTATGGATACCACGA
AACATCAATCGTTTGCAACAAGAATACGAAGCCATGGCATTATTGAACTACGTAACATGT
TCGAGTAAAGAAAATGACTAGCTAGTCGAGGCCCATACATACCATGAAGGGATGACCTCG
TCAGCCATCATCTGATGAAGGGGGTCGGGGTAAGGCATTGATTTGCACATGGTTTCCTGA
CGTCGCTTGGTACGTACCGTAGAGTGAACACGGAGCTCAGAAATCTTATGCATCCGCTGC
GGTATTTTAAACAGCCGTGCAACTGGAACTTTTGGCGCGTTAGCCGATGAATTCTATACA
GCACGCTCCAATTACCTGGCCGAGGGATGCCTCGTTGCTATTTCTCGTAACGTCACTATT
TACAGTACTCATTTGGTCCGGCTGCACATCGCTTATCGTGTAACTCAGGCGTCAGCCGTG
GTTGGGGCATTGGTTACGTCGACTGCGCGGGCGCTCAGAAGCGGGCGACTTTACCGCGTG
TATAATTATCTCTAGGTTTTTTACGGGCCGCTGTGGAATCGGGAGCTGGATTTCGTTCAT
TCTGCTGTCGGCTGACGACAAGGTTATAATACCGCAAAGCCAGAAGCAGTGTTCCGGCAC
AGCCCCATGCGTGCTAGTTTGGGAGGTCGGGCCGGGAGGAACTGTCACCCCATACTCTAC
TGAGTGGTCCACTAACCGTCAGGACTGAGTTAAACAGGATCTTAAGATGACCCTTATTCT
ACCATGTAGGACTTCAGGGCGCAACCACCCTAATCCCTTCATACGGGGATCAGAAGAGAA
ATGGATGCTCCCGTTACCGGCTGGCTAAGGTCGCGCGTTGGTCCCCTTCAGCATTCGTCT
GATTCACTCGCACTAGGACCC
>Rosalind_5439
TCCTCTGACCTTCAACGGGTAAATGTTGGTCCTTGCTGGCAGGTCATATTTGATCGCCCG
ACAGATCGTATGCCCCACAATAAGGAGTTACTGTGCTCAATACATCGTCATCATTCTCTC
TAAGGTATCAGATGAGTCCAGAGAAAAATGCCATCATTCGGGACATGCCAAATTGCTTCC
GGCCCTTGCTAAAGCGAACCTGTAGGGGTCCACGGACATAAAGGGCCTTCCGTCATCGAC
CTGGTGCGTCCTCGCGGCTTGACCGAGGCCCCAATACCCCGTCAGTCCGAAGCCTCACCC
CCGGTTCCACTGTATATGTGCCGCCATAATAGGTCATGGACGTCCGATGCAACCTAATTG
CGCCTAAGGGCCCACTAGCTGCCGTTATGCGCGGAGGGCATAACGCCGGTATATCGAATT
GTTGTGTACGACCACTTCCGATGGTGCACCTACTCCGTAGACAGGAAATGGTTCAACGTA
AGTGGGTCGGATATTTTTGATGACCGACGTGAGAAAGTTGATTGGTGTATGTCGCTACCG
CTTGTTTTTTACTCGACCGGAGGGCGGGCGGCATGGGTATCTCGGAGACTATTGCGTTTG
CTGCTCCTAGAAACTGGTGTAGCCCCAACATGATGTGACGTCGAACGTTTTACTCGAGAG
CGCCGTTATCCAGCGTAACTTGTTGATTTTTCATGTGACCGATCAATTTGACCCGCTGAC
CCGCGATAGTTTCATGTTGATGGTGGTGTATAAATGACAGGGACCTGCGAACCCTCCGTG
AAAGGTAACTGGATTTCCAAATGTACGGTTTGAGCGATCTATCACTTCACCGCAGGTTAG
CCGTACATAAGACTTTACCGAGTGG
>Rosalind_9912
TACGATCACGGACTAAGGTTCATGAAGAATTTTCAAAACCACGGCTACATGTAGCGGCTC
ATTGTCCGTCTCATGACGTATTAGCCCCGCAGGTGTAATCGAAACATGCGGATGTTAGAG
TAAGCGAAGACGAAAGTGCATGGAAGTGATGACACTTAAGTGTTTTCAGGAGCCACTGTG
GCCTCAATGGTCTTCATATGTCAATGTGACGCCAGGGGTTCGAGTATAGACGTGATGATC
CAAACTCATTGCGTCGCTCATGCCCCGGCTGGTAGAGAGCAATCTTGACAGCCCGAAGAT
GTTCAACATAAGTGACTAAAAAGACAAGGCCTGAGACATGCACCGCGAGTTCAGATCATT
TTATAGCGCCGAGGGCATCTACTTCAATGAAGGGTACTAGTTGATCCCATTTGTTAAGCG
TTCCAGGTCAGTTGGAGCTCAGATTGGTTTGGCGGGAGTGGAACACGTCAGACATCTGCC
GGTGGACTTCTGGCGGCTACAGAAACTATAGTTTATGGCCGTTACCCTCAGTCGAGCGGC
GGGAAGTAGCGAATAGCCTGGAGATGGGAGCCTAGACTGACCAGCGCCCTCGTCGCACGT
TCTGTTCGATTTTTAATGCGAACCACCGTGCGGCCGTCTTGGCGGTTCTGCAAACTTCCC
TAGGCGGACGCTCTTTATAAATGTCTCCTCCCGTCACGCAACTTCCCCACTACCCGGTTA
CATATGGTTCGCGCTACGCATTACGTGCGGAGACGGTGAATTACCCACCTGTGCTAGATT
GAGTCAGGTATCACGTTTCATTATTTTTCTCCCCTGAAAATGTCAATCTTTGACATCTAG
TTGGGAGAACAAAAGCGGCGATCGAGCGGTGCTATAGTCTATGGTTCGGTCACCCCGGTC
TGCCGATGTTAA
>Rosalind_6859
CGGATAACCTTCTACTAGACGCATATTCCAAATAGCGGACTAGTTAAGAGTGTAGGTCGG
AGGCGGGCGTAGTCGAGAAGATAAAGTATATGGGCTAAGACTAAAGTATTCCGGCCCTCG
AGTACTTCGCCGGTAAGTGCCCGTCAGACCGGACACCCTAACAGGGAATTTGGTTTAGAG
TGGGATGCTTTCGAAGCCCGGAATACCTTTCGATGGTGCACGCTACGGAGCGCTGTATAA
TCCAGACGACGTAGCGTTTCCTCGGATGGATCAATGTTGTGAAGGTACCGATCCCTAACA
GGTACATCAGTAGGCCTGTGTCGATACAGACGTTCAGGATCAGTGCAGGAGTAGGCAATG
GGCATCCTTCTTGAAGAAATCACAGGCTACGTTGCAAAGAAAATACGCTTTTGCGTGACG
GGTGATTTGGTTTGTCTCAATAGACTCCTCGAGAGTCAACTCATTATGGTACCGACAGTG
AATTAGAACAAAACGCCGAGTGTTGTGGGATTCACAAGATCTAACATGAAATCTGTAACC
GTGCGGCGTAATCATCGGACTGGCGTGCCGATAACGCTTTACCTGGCTTAGAGCCATGTT
CATCTCGGTCGATACAATGTATCGCAAGCGTATGTCGGTTACTGTGGATCAAGAATGAGA
ACCTCCACATGCCTCAAGAACTCACAATATTCAACCCTGTACATTTAGCGGCCTGTTAGG
ACCGCTGTAACATATGGGACTATAGAGCAGGCCTTCGACCGTTAACGGAACCGTAGAAGA
TTAGTAGTAGGGCTCACACTCGACCGGTCGCCAGGGGGTGGAGGAGCACGCCACGCTGGC
TATTGGGTATCATAAGCTTCTGGATCGTCTATATTATCGTGCCGCCTTCTCAAAGACGAC
TCTCTTGGCCGTTGCGTATTCTTAG
>Rosalind_4308
ACTGAACTCTATGCGCCTTGAAGAGCAGAGCATATAGCCAGCAACCCTAAGAAGCCTGGT
CCTCGAATCTCCAACTGGGATGTCATTGTACAAAGCCTCCAACGTTCAAGGATCCGCCTA
AGCGCCAGACCGGTGGGGACTAGTGATCCCGTACGTGTGCTACGACAAAGTGGCCGCACA
AGGAGCCAAGATCGTTTCCGTTCTGGGCTATCGCTGACTATGTTTCGCGCCGCTGTCCCT
TCCCTCATTCTGTATAAATCTTGTCCGTATGTGGTTCCTACACGCCGTTCCTGGTCGGAG
TGGTAACGCTAAGTTAGAGAAGCGGGCCTTTTCCTCGGTTCGGGGTATTATGCGGCTTCA
GCACTCAGTATCGCCAATATATCACCGCCCACGGTGGTGATTGGCATTTATACACCGCGT
ACATGTCGTGATGTTCACCCAGTTACTGGTGTGCGTCACCAGTATCACTCTACTTCGTCG
GCCTTCATATACATGAGCCAACCCTGCACGTGCGGACCTTGTGGTTGTGTTTAAAGGCAG
ACTTATCGGAAGGGTAACCGGACTTCTTGGCCAGGCAGAATCTTATGAGGATGAAACAAC
AAAGCAACTATGTTAGTGAGCTGATACGAATCCCGCGAAAAAAGCTGCTGGTTAGGCCCT
CCAAACATATTTAGCTCAGGGGAGTGCGAAGAGTCCCCGTCAATGTGACCCGGCGGATTA
CAGTGCTTGATCACTGTGGTGGCCTTCACATGTGCGCATGATCATAAGGCGCCACAAGTA
AAAAAGTGGGTGTGCCTAAATCGGAAGCACGATTGGTAGTGGTTACACAGCAGCAGAGGC
ACTCCTACGTCCGGGGCGATCTGTCATTTGCCTGGATCCGTCTTATGGGCTGGAACTACT
CCAAGCGAC
